width=32
height=6
10000011110000011111110000000001
10000010000000010000000000000001
10000010000001100000000000000001
10011110000100000010000000000001
10000000100000010010000000000001
11111111100010110011111111111111
