width=32
height=6
00000000000000000000000000000000
00000000000000000000000000000000
00001000000000000000000000000000
00000000000000000000000000000000
10000010000000000000000000000000
11111111000000000000000000000000
